2020-03-31,6,113,77,36,2.1389
2020-03-30,9,107,76,31,2.4516
2020-03-29,11,98,68,30,2.2667
2020-03-28,11,87,65,22,2.9545
2020-03-27,4,76,62,14,4.4286
2020-03-26,2,72,59,13,4.5385
2020-03-25,6,70,60,10,6.0000
2020-03-24,10,64,56,8,7.0000
2020-03-23,7,54,48,6,8.0000
2020-03-22,5,47,44,3,14.6667
2020-03-21,4,42,41,1,41.0000
2020-03-20,2,38,37,1,37.0000
