2020-04-07,14,244,170,73,2.3288
2020-04-06,13,230,174,56,3.1071
2020-04-05,7,217,176,41,4.2927
2020-04-04,6,210,175,35,5.0000
2020-04-03,17,204,176,28,6.2857
2020-04-02,14,187,174,13,13.3846
2020-04-01,9,173,161,12,13.4167
2020-03-31,17,164,157,7,22.4286
2020-03-30,18,147,140,7,20.0000
2020-03-29,9,129,123,6,20.5000
2020-03-28,18,120,114,6,19.0000
2020-03-27,16,102,100,2,50.0000
2020-03-26,12,86,84,2,42.0000
