2020-04-07,3,172,126,45,2.8000
2020-04-06,11,169,131,38,3.4474
2020-04-05,5,158,125,33,3.7879
2020-04-04,7,153,131,22,5.9545
2020-04-03,13,146,129,17,7.5882
2020-04-02,10,133,122,11,11.0909
2020-04-01,8,123,116,7,16.5714
2020-03-31,13,115,109,6,18.1667
2020-03-30,14,102,98,4,24.5000
2020-03-29,12,88,85,3,28.3333
2020-03-28,8,76,74,2,37.0000
2020-03-27,5,68,66,2,33.0000
2020-03-26,11,63,61,2,30.5000
2020-03-25,6,52,51,1,51.0000
