2020-04-04,6,210,169,41,4.1220
2020-04-03,17,204,169,35,4.8286
2020-04-02,14,187,159,28,5.6786
2020-04-01,9,173,160,13,12.3077
2020-03-31,17,164,152,12,12.6667
2020-03-30,18,147,140,7,20.0000
2020-03-29,9,129,122,7,17.4286
2020-03-28,18,120,114,6,19.0000
2020-03-27,16,102,96,6,16.0000
2020-03-26,12,86,84,2,42.0000
2020-03-25,18,74,72,2,36.0000
2020-03-24,15,56,55,1,55.0000
