2020-04-02,14,187,152,35,4.3429
2020-04-01,9,173,145,28,5.1786
2020-03-31,17,164,151,13,11.6154
2020-03-30,18,147,135,12,11.2500
2020-03-29,9,129,122,7,17.4286
2020-03-28,18,120,113,7,16.1429
2020-03-27,16,102,96,6,16.0000
2020-03-26,12,86,80,6,13.3333
2020-03-25,18,74,72,2,36.0000
2020-03-24,15,56,54,2,27.0000
2020-03-23,6,41,40,1,40.0000
