2020-03-29,11,98,67,31,2.1613
2020-03-28,11,87,57,30,1.9000
2020-03-27,4,76,54,22,2.4545
2020-03-26,2,72,58,14,4.1429
2020-03-25,6,70,57,13,4.3846
2020-03-24,10,64,54,10,5.4000
2020-03-23,7,54,46,8,5.7500
2020-03-22,5,47,41,6,6.8333
2020-03-21,4,42,39,3,13.0000
2020-03-20,2,38,37,1,37.0000
2020-03-19,5,36,35,1,35.0000
