2020-04-03,7,136,94,41,2.2927
2020-04-02,7,129,91,38,2.3947
2020-04-01,9,122,86,36,2.3889
2020-03-31,6,113,82,31,2.6452
2020-03-30,9,107,77,30,2.5667
2020-03-29,11,98,76,22,3.4545
2020-03-28,11,87,73,14,5.2143
2020-03-27,4,76,63,13,4.8462
2020-03-26,2,72,62,10,6.2000
2020-03-25,6,70,62,8,7.7500
2020-03-24,10,64,58,6,9.6667
2020-03-23,7,54,51,3,17.0000
2020-03-22,5,47,46,1,46.0000
