2020-04-08,11,255,181,74,2.4459
2020-04-07,14,244,188,56,3.3571
2020-04-06,13,230,189,41,4.6098
2020-04-05,7,217,182,35,5.2000
2020-04-04,6,210,182,28,6.5000
2020-04-03,17,204,191,13,14.6923
2020-04-02,14,187,175,12,14.5833
2020-04-01,9,173,166,7,23.7143
2020-03-31,17,164,157,7,22.4286
2020-03-30,18,147,141,6,23.5000
2020-03-29,9,129,123,6,20.5000
2020-03-28,18,120,118,2,59.0000
2020-03-27,16,102,100,2,50.0000
2020-03-26,12,86,85,1,85.0000
