2020-04-09,1,61,43,18,2.3889
2020-04-08,0,60,46,14,3.2857
2020-04-07,2,60,49,11,4.4545
2020-04-06,2,58,48,10,4.8000
2020-04-05,7,56,49,7,7.0000
2020-04-04,4,49,41,8,5.1250
2020-04-03,4,45,40,5,8.0000
2020-04-02,3,41,37,4,9.2500
2020-04-01,2,38,35,3,11.6667
2020-03-31,5,36,35,1,35.0000
2020-03-30,6,31,30,1,30.0000
2020-03-29,4,25,24,1,24.0000
2020-03-28,3,21,20,1,20.0000
