2020-03-27,120,569,458,109,4.2018
2020-03-26,0,449,368,81,4.5432
2020-03-25,75,449,390,59,6.6102
2020-03-24,59,374,328,46,7.1304
2020-03-23,32,315,289,26,11.1154
2020-03-22,45,283,262,21,12.4762
2020-03-21,29,238,221,17,13.0000
2020-03-20,34,209,196,13,15.0769
2020-03-19,21,175,170,5,34.0000
2020-03-18,21,154,149,5,29.8000
2020-03-17,22,133,129,4,32.2500
