2020-04-02,13,129,106,23,4.6087
2020-04-01,40,116,96,20,4.8000
2020-03-31,2,76,59,17,3.4706
2020-03-30,10,74,60,14,4.2857
2020-03-29,0,64,55,9,6.1111
2020-03-28,4,64,56,8,7.0000
2020-03-27,12,60,54,6,9.0000
2020-03-26,5,48,43,5,8.6000
2020-03-25,5,43,40,3,13.3333
2020-03-24,9,38,36,2,18.0000
2020-03-23,6,29,28,1,28.0000
